0x00: 0000
0x01: 0000
0x02: 0000
0x03: 000A
0x04: 0000
0x05: 3998
0x06: 0F02
0x07: 0000
0x08: 0064
0x09: 0064
0x0A: 0000
0x0B: 0000
0x0C: 0000
0x0D: 0000
0x0E: 0000
0x0F: 0000
0x10: 0000
0x11: 0000
0x12: 0000
0x13: 0000
0x14: 0000
0x15: 0000
0x16: 0000
0x17: 0000
0x18: 0000
0x19: 0000
0x1A: 0002
0x1B: 0008
0x1C: 0000
0x1D: 0008
0x1E: 0226
0x1F: 0000
0x20: 0000
0x21: 0000
0x22: 0000
0x23: 0000
0x24: 9800
0x25: 0000
0x26: 0000
0x27: 0000
0x28: 0000
0x29: 0000
0x2A: 0017
0x2B: 0000
0x2C: FFDE
0x2D: 000A
0x2E: 0000
0x2F: 0000
0x30: FFF2
0x31: 000A
0x32: FFDE
0x33: 0001
0x34: 0000
0x35: 0000
0x36: 0000
0x37: 0000
0x38: 0000
0x39: 0000
0x3A: 0000
0x3B: 0000
0x3C: 0000
0x3D: 0000
0x3E: 0000
0x3F: 0000
0x40: 0000
0x41: 0000
0x42: 0000
0x43: 0000
0x44: 0000
0x45: 0000
0x46: 0000
0x47: 0000
0x48: 0000
0x49: 0000
0x4A: 0000
0x4B: 0000
0x4C: 0000
0x4D: 0000
0x4E: 0000
0x4F: 0000
0x50: 0005
0x51: FF03
0x52: 0000
0x53: 0000
0x54: 0020
0x55: 0000
0x56: 0000
0x57: 9800
0x58: 0000
0x59: 00FF
0x5A: 0001
0x5B: 005B
0x5C: 0000
0x5D: 0000
0x5E: 0000
0x5F: 0000
0x60: 0000
0x61: 0001
0x62: 002A
0x63: 0000
0x64: 0000
0x65: 0000
0x66: 0000
0x67: 0000
0x68: 0000
0x69: 0000
0x6A: 0000
0x6B: 0000
0x6C: 0000
0x6D: 0000
0x6E: 0000
0x6F: 0000
0x70: 0000
0x71: 0000
0x72: 0000
0x73: 0000
0x74: 0000
0x75: 0000
0x76: 0000
0x77: 0000
0x78: 0000
0x79: 0000
0x7A: 0000
0x7B: 0000
0x7C: 0000
0x7D: 0000
0x7E: 0000
0x7F: 0000
0x80: 0000
0x81: 0000
0x82: 0000
0x83: 0000
0x84: 0000
0x85: 0000
0x86: 0000
0x87: 0000
0x88: 0000
0x89: 0000
0x8A: 0000
0x8B: 0000
0x8C: 0000
0x8D: 0000
0x8E: 0000
0x8F: 0100
0x90: 0000
0x91: 0000
0x92: 0000
0x93: FFF3
0x94: 0000
0x95: 000A
0x96: FFDE
0x97: 0A4D
0x98: 0030
0x99: 0F02
0x9A: 0000
0x9B: 0007
0x9C: 0001
0x9D: 4800
0x9E: 0CD9
0x9F: 00D6
0xA0: 00A0
0xA1: 00A1
0xA2: 00A2
0xA3: 00A3
0xA4: 00A4
0xA5: 00A5
0xA6: 00A6
0xA7: 00A7
0xA8: 00A8
0xA9: 00A9
0xAA: 00AA
0xAB: 00AB
0xAC: 00AC
0xAD: 00AD
0xAE: 00AE
0xAF: 00AF
0xB0: 00B0
0xB1: 00B1
0xB2: 00B2
0xB3: 00B3
0xB4: 00B4
0xB5: 00B5
0xB6: 00B6
0xB7: 00B7
0xB8: 00B8
0xB9: 00B9
0xBA: 00BA
0xBB: 00BB
0xBC: 00BC
0xBD: 00BD
0xBE: 00BE
0xBF: 00BF
0xC0: 00C0
0xC1: 00C1
0xC2: 00C2
0xC3: 00C3
0xC4: 00C4
0xC5: 00C5
0xC6: 00C6
0xC7: 00C7
0xC8: 00C8
0xC9: 00C9
0xCA: 00CA
0xCB: 00CB
0xCC: 00CC
0xCD: 00CD
0xCE: 00CE
0xCF: 00CF
0xD0: 00D0
0xD1: 00D1
0xD2: 00D2
0xD3: 00D3
0xD4: 00D4
0xD5: 00D5
0xD6: 00D6
0xD7: 00D7
0xD8: 00D8
0xD9: 00D9
0xDA: 00DA
0xDB: 00DB
0xDC: 00DC
0xDD: 00DD
0xDE: 00DE
0xDF: 00DF
0xE0: 00E0
0xE1: 00E1
0xE2: 00E2
0xE3: 00E3
0xE4: 00E4
0xE5: 00E5
0xE6: 00E6
0xE7: 00E7
0xE8: 00E8
0xE9: 00E9
0xEA: 00EA
0xEB: 000A
0xEC: 0000
0xED: 0003
0xEE: 0988
0xEF: 0003
0xF0: 0000
0xF1: 0000
0xF2: 0000
0xF3: 0000
0xF4: 0000
0xF5: 0000
0xF6: 0002
0xF7: 0000
0xF8: 00FF
0xF9: 0026
0xFA: 0000
0xFB: 0000
0xFC: 0017
0xFD: 0001
0xFE: 00FE
0xFF: 0000
